R 1200 800

NO ./textures/1_north.xpm
SO ./textures/2_souht.xpm
WE ./textures/3_west.xpm

EA ./textures/4_east.xpm
S ./textures/0_sprite.xpm
F 105,105,105
C 176,224,230


111111111111111111111111111
100001000100110000000000001
101111011000010000000000001
100001001000000000002000201
1001110110000011100000E0001
100200001000000100000200011
110000011000000111110000201
100000000000202000110011111
111000200011000011120000111
110000001111000110000000001
110020000001100011000000001
111111000011100000000111111
111111111111111111111111111