
R 1200 800

NO ./textures/1_north.xpm
SO ./textures/2_souht.xpm

F 105,105,105



WE ./textures/3_west.xpm
EA ./textures/4_east.xpm
S ./textures/0_sprite.xpm

C 176,224,230

                                111111
                                   101
11111111111111111111111111111111111101 11111111111
10010001000100000010000000000000000001 10000000111
10010001000100000000000000010000000001 10000000001
10111011101100111110111111111011111111 11111111111
10101010101000101010101010101010101011            
10101000000010101010101010101010101011111111111111
10001010101010101010101010101010101010101010001001
11101011111011111110111111111011111111111111011111
12000000000000002200111121110000000000000000012001
12000000000002200000111111112000020000020000010001
12000002000002200000000000000000000000002001010001
10200000000000000000000000002000E00000000000010001
10020000002000000000111111110200000200002000000001
10000000000000002000111111110200002200000000002001
11111110000111111111111111111111011111111111111111
      10000000000000000000000002011111111111000021
      10000000000000000011111100000001110000021111
      11111111111111111111111111111111 11111111111