

SO ./textures/2_souht.xpm
R 1200 800

NO ./textures/1_north.xpm

WE ./textures/3_west.xpm

C 001,001,001

EA ./textures/4_east.xpm
S ./textures/0_sprite.xpm
F 000,000,000

                                111111
                                   101
            11111111111111111111111101111111111111
            10000010000000000000000001110000000111
            10000000000000010000000001110000000001
            10111110111111111011111111111111111111
            10101010111111111110101011111111111111
            111111111         10101011111111111111
                              10101010101010001001
1111111111                    11111111111111011111
11000000011111111111111121111110000000000000012001
120000000000020000001111111120000200000001200100W1
12000002000000200000000000000000000000000100012001
10000000000000000000000000002000000000000100010001
10020000000000000000111111110200000200001112000001
10000002000000002000111111110200002011111 11111111
1111111000011111111111111111111101111             
      1000000000000000000000000001111             
      1000000000000000001111110000001             
      1111111111111111111111111111111             
11111111111111111111111111111111111111111111111111
10010001000100000010000000000000000001110000000111
10010001000100000000000000010000000001110000000001
10111011101100111111111111111111111111111111111111
101010101010001                  11011111111111111
101010000000101                  11011111111111111
110010101010101                  11010101010001001
111010111110111                  11111111111011111
11000000000000111111111111111111110000000000012001
12000000000002200000111111112000020000020000010001
12000002000002200000000000000000000000002001010001
10200000000000000000000000002000000000000000010001
10020000002000001111111111110200000200002000000001
10000000000000001        1110200002200000000002001
11111110000111111        1111111011111111111111111
      10000000001        1000002011111111111000021
      10000000001        1111100000001110000021111
      11111111111        1111111111111 11111111111